16
14
0 0 0 0 0 0 0 0 0 10 0 0 0 0 0 0
2 0 0 0 0 0 0 0 0 0 0 10 0 10 0 0 
0 0 0 8 6 6 6 6 6 0 0 0 0 0 0 0 
0 0 0 0 0 0 3 0 0 0 0 0 0 0 0 0 
6 0 0 0 0 0 0 0 0 0 0 0 0 0 0 0 
6 0 0 0 0 0 0 0 0 0 0 0 0 0 0 0 
4 0 0 0 0 0 0 0 0 0 0 0 0 0 0 0 
6 0 0 0 0 0 0 0 0 0 0 0 0 0 0 0 
6 0 0 0 0 0 0 0 0 0 0 0 0 0 0 0 
0 0 4 0 4 0 4 0 0 0 0 0 0 0 0 1 
8 0 0 0 0 0 0 0 4 0 0 0 0 0 0 0 
10 0 8 0 0 0 0 0 0 0 0 0 0 0 0 0 
0 0 0 0 0 0 0 0 0 0 0 0 0 0 0 0 
0 0 0 8 0 0 0 0 0 0 0 0 0 0 0 5
